//MAP CONVERTED BY dmm2tgm.py THIS HEADER COMMENT PREVENTS RECONVERSION, DO NOT REMOVE
"a" = (
/turf/simulated/floor/tiled,
/area/space)
"b" = (
/obj/machinery/atmospherics/unary/vent_pump/on{
	dir = 4
	},
/turf/simulated/floor/tiled,
/area/space)
"c" = (
/obj/machinery/atmospherics/pipe/simple/hidden/scrubbers{
	dir = 10
	},
/turf/simulated/floor/tiled,
/area/space)
"g" = (
/obj/machinery/atmospherics/pipe/simple/hidden/supply{
	dir = 8
	},
/turf/simulated/floor/tiled,
/area/space)
"h" = (
/obj/machinery/atmospherics/pipe/simple/hidden/scrubbers{
	dir = 8
	},
/turf/simulated/floor/tiled,
/area/space)
"i" = (
/obj/machinery/atmospherics/pipe/manifold/hidden/supply{
	dir = 8
	},
/turf/simulated/floor/tiled,
/area/space)
"l" = (
/obj/machinery/atmospherics/pipe/simple/hidden/scrubbers{
	dir = 5
	},
/turf/simulated/floor/tiled,
/area/space)
"o" = (
/obj/machinery/atmospherics/pipe/manifold/hidden/scrubbers{
	dir = 1
	},
/turf/simulated/floor/tiled,
/area/space)
"p" = (
/obj/machinery/atmospherics/pipe/simple/hidden/scrubbers,
/turf/simulated/floor/tiled,
/area/space)
"t" = (
/obj/machinery/atmospherics/pipe/simple/hidden/scrubbers{
	dir = 9
	},
/turf/simulated/floor/tiled,
/area/space)
"v" = (
/turf/simulated/wall/r_wall,
/area/space)
"y" = (
/obj/machinery/atmospherics/pipe/simple/hidden/supply{
	dir = 9
	},
/turf/simulated/floor/tiled,
/area/space)
"z" = (
/obj/machinery/atmospherics/unary/vent_scrubber/on,
/turf/simulated/floor/tiled,
/area/space)
"A" = (
/obj/machinery/atmospherics/pipe/manifold/hidden/supply{
	dir = 1
	},
/turf/simulated/floor/tiled,
/area/space)
"C" = (
/obj/machinery/atmospherics/pipe/manifold/hidden/supply,
/turf/simulated/floor/tiled,
/area/space)
"D" = (
/obj/machinery/atmospherics/pipe/simple/hidden/scrubbers{
	dir = 4
	},
/turf/simulated/floor/tiled,
/area/space)
"E" = (
/obj/machinery/atmospherics/pipe/simple/hidden/supply{
	dir = 5
	},
/turf/simulated/floor/tiled,
/area/space)
"I" = (
/obj/machinery/atmospherics/pipe/simple/hidden/supply{
	dir = 4
	},
/turf/simulated/floor/tiled,
/area/space)
"J" = (
/obj/machinery/atmospherics/pipe/manifold4w/hidden/scrubbers,
/turf/simulated/floor/tiled,
/area/space)
"K" = (
/obj/machinery/atmospherics/unary/vent_pump/on{
	dir = 1
	},
/turf/simulated/floor/tiled,
/area/space)
"L" = (
/obj/machinery/atmospherics/pipe/manifold/hidden/supply{
	dir = 4
	},
/turf/simulated/floor/tiled,
/area/space)
"M" = (
/obj/machinery/atmospherics/pipe/manifold/hidden/scrubbers{
	dir = 8
	},
/turf/simulated/floor/tiled,
/area/space)
"N" = (
/obj/machinery/atmospherics/pipe/manifold/hidden/scrubbers{
	dir = 4
	},
/turf/simulated/floor/tiled,
/area/space)
"O" = (
/obj/machinery/atmospherics/pipe/simple/hidden/supply{
	dir = 10
	},
/turf/simulated/floor/tiled,
/area/space)
"Q" = (
/obj/machinery/atmospherics/unary/vent_pump/on,
/turf/simulated/floor/tiled,
/area/space)
"R" = (
/obj/machinery/atmospherics/pipe/manifold/hidden/scrubbers,
/turf/simulated/floor/tiled,
/area/space)
"S" = (
/obj/machinery/atmospherics/pipe/simple/hidden/scrubbers{
	dir = 1
	},
/turf/simulated/floor/tiled,
/area/space)
"T" = (
/obj/machinery/atmospherics/pipe/simple/hidden/supply,
/turf/simulated/floor/tiled,
/area/space)
"U" = (
/obj/machinery/atmospherics/pipe/simple/hidden/scrubbers{
	dir = 6
	},
/turf/simulated/floor/tiled,
/area/space)
"V" = (
/obj/machinery/atmospherics/pipe/simple/hidden/supply{
	dir = 1
	},
/turf/simulated/floor/tiled,
/area/space)
"W" = (
/obj/machinery/atmospherics/unary/vent_pump/on{
	dir = 8
	},
/turf/simulated/floor/tiled,
/area/space)
"Y" = (
/obj/machinery/atmospherics/pipe/manifold4w/hidden/supply,
/turf/simulated/floor/tiled,
/area/space)
"Z" = (
/obj/machinery/atmospherics/pipe/simple/hidden/supply{
	dir = 6
	},
/turf/simulated/floor/tiled,
/area/space)

(1,1,1) = {"
a
a
a
a
a
a
a
a
a
a
a
a
a
a
a
a
a
a
a
a
a
a
a
a
a
"}
(2,1,1) = {"
a
b
a
b
a
a
a
v
a
a
a
a
a
a
a
a
a
a
a
a
a
a
a
a
a
"}
(3,1,1) = {"
a
Y
Y
Y
Y
Y
a
v
a
Z
y
O
E
g
I
T
V
a
i
L
C
A
a
Y
a
"}
(4,1,1) = {"
a
a
a
W
a
W
a
v
a
a
a
a
a
a
a
a
a
a
a
a
a
a
a
a
a
"}
(5,1,1) = {"
a
a
a
a
a
a
a
v
a
U
t
c
l
h
D
p
S
a
M
N
R
o
a
J
a
"}
(6,1,1) = {"
a
Y
K
a
Y
K
a
v
a
a
a
a
a
a
a
a
a
a
a
a
a
a
a
a
a
"}
(7,1,1) = {"
a
Y
a
a
Y
a
a
v
a
a
a
a
a
a
a
a
a
a
a
a
W
b
Q
K
a
"}
(8,1,1) = {"
a
Y
a
Q
Y
K
a
v
a
a
a
a
a
a
a
a
a
a
a
a
a
a
a
a
a
"}
(9,1,1) = {"
a
a
a
a
Y
a
a
v
a
a
a
a
a
a
a
a
a
a
a
a
a
a
a
z
a
"}
(10,1,1) = {"
a
a
a
Q
Y
a
a
v
a
a
a
a
a
a
a
a
a
a
a
a
a
a
a
a
a
"}
(11,1,1) = {"
a
a
a
a
a
b
a
v
v
v
v
v
v
v
v
v
v
v
v
v
v
v
v
v
a
"}
(12,1,1) = {"
a
Y
a
Y
Y
Y
a
a
a
a
a
a
a
a
a
a
a
a
a
a
a
a
a
a
a
"}
(13,1,1) = {"
a
Y
a
W
a
a
a
a
b
a
a
a
Y
a
a
a
a
Y
a
a
a
Y
a
a
a
"}
(14,1,1) = {"
a
Y
a
a
Y
Y
Y
Y
Y
Y
a
Y
Y
a
a
a
Y
Y
a
a
a
Y
a
a
a
"}
(15,1,1) = {"
a
Y
a
a
a
W
a
a
a
a
a
a
a
a
a
a
a
Y
Y
a
a
Y
a
a
a
"}
(16,1,1) = {"
a
Y
Y
Y
a
a
a
a
a
a
a
a
Y
a
a
a
a
Y
a
a
a
Y
a
a
a
"}
(17,1,1) = {"
a
Y
a
Y
Y
Y
Y
a
a
a
a
a
Y
Y
a
a
Y
Y
a
a
a
Y
a
a
a
"}
(18,1,1) = {"
a
Y
a
Y
a
a
Y
a
a
Y
a
a
a
a
a
a
a
Y
a
a
a
Y
a
a
a
"}
(19,1,1) = {"
a
Y
a
Y
a
a
Y
a
Q
Y
a
Y
Y
a
a
a
a
a
a
a
a
a
a
a
a
"}
(20,1,1) = {"
a
Y
Y
Y
Y
Y
Y
a
a
Y
a
a
Y
a
a
Y
Y
Y
Y
Y
Y
Y
a
a
a
"}
(21,1,1) = {"
a
a
Y
a
a
a
Y
a
a
Y
a
a
a
a
a
a
a
a
a
a
a
a
a
a
a
"}
(22,1,1) = {"
a
a
Y
a
a
a
Y
a
a
Y
K
a
Y
Y
a
a
Y
a
a
a
Y
a
a
a
a
"}
(23,1,1) = {"
a
Y
Y
Y
Y
Y
Y
Y
a
Y
a
a
Y
a
a
Y
Y
Y
Y
Y
Y
Y
a
a
a
"}
(24,1,1) = {"
a
a
Y
a
Y
a
Y
a
a
a
a
a
a
a
a
a
Y
a
Y
a
a
a
a
a
a
"}
(25,1,1) = {"
a
a
a
a
a
a
a
a
a
a
a
a
a
a
a
a
a
a
a
a
a
a
a
a
a
"}
